11111111111111111111111111111111111
10060000000000000000000000000000001
10011100111001110011100111001111001
10011100111001110011100111001111001
10011100111001110011100111001111001
10000000000000000000000000000000001
10011100111001110011100111001111001
10011100111001110011100111001111001
10011100111001110011100111001111001
10000000000000000000000000000000001
10011100111001110011100111001111001
10011100111001110011100111001111001
10011100111001110011100111001111001
10000000000000000000000000000000001
10011100111001110011100111001111001
10011100111001110011100111001111001
10011100111001110011100111001111001
10000000000000000000000000000000001
10011100111001110011100111001111001
10011100111001110011100111001111001
10011100111001110011100111001111001
10000000000000000000000000000000001
10011100111001110011100111001111001
10011100111001110011100111001111001
10011100111001110011100111001111001
10000000000000000000000000000000001
10011100111001110011100111001111001
10011100111001110011100111001111001
10011100111001110011100111001111001
10000000000000000000000000000000001
11111111111111111111111111111111111